essere — быть
avere — иметь
fare — делать
dire — говорить
potere — мочь
andare — идти
vedere — видеть
dare — давать
sapere — знать
volere — хотеть
trovare — находить
parlare — говорить
pensare — думать
guardare — смотреть
sentire — слышать
lasciare — оставлять
prendere — брать
mettere — класть
vivere — жить
chiedere — спрашивать
tenere — держать
portare — приносить
credere — верить
cominciare — начинать
aspettare — ждать
uscire — выходить
arrivare — прибывать
lavorare — работать
scrivere — писать
leggere — читать
studiare — учиться
aprire — открывать
chiudere — закрывать
giocare — играть
correre — бегать
camminare — гулять
cucinare — готовить
mangiare — есть
bere — пить
dormire — спать
alzarsi — вставать
sedersi — садиться
lavarsi — умываться
vestirsi — одеваться
entrare — входить
rimanere — оставаться
tornare — возвращаться
salire — подниматься
scendere — спускаться
comprare — покупать
vendere — продавать
pagare — платить
costare — стоить
guidare — водить
viaggiare — путешествовать
visitare — посещать
telefonare — звонить
ascoltare — слушать
incontrare — встречать
aiutare — помогать
provare — пробовать
nuotare — плавать
ballare — танцевать
cantare — петь
suonare — играть (на инструменте)
ridere — смеяться
piangere — плакать
amare — любить
odiare — ненавидеть
preferire — предпочитать
capire — понимать
ricordare — помнить
dimenticare — забывать
insegnare — преподавать
imparare — учить
pulire — чистить
preparare — подготавливать
cercare — искать
perdere — терять
vincere — побеждать
scegliere — выбирать
spiegare — объяснять
controllare — проверять
usare — использовать
creare — создавать
costruire — строить
rompere — ломать
riparare — чинить
camminare — идти пешком
correre — бежать
accendere — включать
spegnere — выключать
entrare — входить
uscire — выходить
muovere — двигать
fermare — останавливать
